present	N/A	furpresent @member
Present yourself to someone~
bang	fuck	furbang [@user]
bulge	N/A	furbulge @user
cocksize	N/A	furcocksize [@user]
Detects user's penis length. Enter multiple users for an accurate comparison!
finger	N/A	furfinger @user
ncuddle	nsnuggle, nsnuggles, ncuddles	furncuddle @user
nhold	N/A	furnhold @user
nhug	nhuggles, nhuggies, nhuddles, nhugs, nhuggle	furnhug @user
Latch onto a friend and have some fun!
nkiss	nkisses, nkissies	furnkiss @user
seduce	N/A	furseduce [@user]
nlick	N/A	furnlick @user
npickup	N/A	furnpickup
smash	N/A	fursmash [@user] [@user2]
spank	spankies	furspank [@user]
suck	slurp, sucks, suckies	fursuck @user
tease	N/A	furtease [@user]
ride	N/A	furride [@user]
ride the the penis of someone