birb	N/A	furbirb
For the birds
bunny	bun	furbunny
duck	N/A	furduck
fox	N/A	furfox
koala	N/A	furkoala
meow	N/A	furmeow
send	N/A	fursend <user mention(or)userid>
sends a sfw picture to <user mention(or)user id>
mur	N/A	furmur
nature	N/A	furnature
neko	N/A	furneko [ gif | kitsune | sfw ]
panda	N/A	furpanda
panda red	N/A	furpanda red
pig	N/A	furpig
raccoon	N/A	furraccoon
sadcat	N/A	fursadcat
Retrieves an image of a sad cat. The feels are real... ;w;
snep	sneps	fursnep
woof	N/A	furwoof | furwoof [breed]
Dogs!
woof breeds	N/A	furwoof breeds
A list of all breeds that you can use with the main.java.bot!
wuf	wolves	furwuf