bisexual	bi	furbisexual
solo	N/A	solo [fsolo|msolo]
posts an image of a solo male/female
cuntboy	cuntboi, cuntboye	furcuntboy
dick	dicks	furdick
dp	N/A	furdp
(Double Penetration)
femboy	femboi, femboye	furfemboy
futa	futas	furfuta
gay	N/A	furgay
gif	N/A	furgif
lesbian	N/A	furlesbian
ncomic	comic	furncomic
neko	N/A	furneko [ ngif | nsfw ]
npokemon	npokeporn	furnpokemon
preg	pregnant	furpreg
pussy	vagina	furpussy
snp	N/A	fursnp
The Smash or Pass
trap	traps	furtraps
yiff	lewd, yiffy	furyiff
yiffmas	N/A	furyiffmas
yiff bang	N/A	furyiff bang
yiff cuddle	N/A	furyiff cuddle
yiff hug	N/A	furyiff hug
yiff kiss	N/A	furyiff kiss
yiff lick	N/A	furyiff lick
yiff tease	N/A	furyiff tease
ass	booty, butt	furass